####################
#                  #
#  1111111111111111#
#                  #
#  ############## 1#
#       #     #   1#
#       #   1 #   1#
#     1 # ####    1#
#      1          1#
#       1         1#
#        1        1#
####      1       1#
#111#1# #  1      1#
#1  1       1     1#
####################